{"level":[
  40,35,25,10,1,1,1,20,25,25,
  30,25,20,10,1,1,1,1,20,25,
  25,20,10,10,10,1,1,1,1,15,
  20,1,1,1,1,1,1,1,1,10,
  1,1,1,1,1,1,1,1,1,1,
  1,5,1,7,1,1,1,1,1,1,
  10,7,7,5,10,1,1,1,1,1,
  35,10,7,5,3,3,1,1,1,1,
  32,15,10,7,5,1,1,1,1,1,
  30,10,15,10,5,1,1,1,1,1
],
"dim":9}
